########################
#                      #
#    P                 #
#                      #
#                      #
############           #
#                      #
#                      #
#   O         X        #
#                      #
########################